********
*IC**SC*
**C***C*
**C***C*
**CCCCC*
********