********
*IC*****
**C*****
*CC*****
*C******
*C******
*S******
********
