********
***SCC**
*IC**CC*
**C***C*
**C***C*
**CCCCC*
********